13,13,13,13,13,13,13,13
00,00,00,00,00,00,00,00
01,01,01,01,01,01,01,01
02,02,02,04,02,03,02,02
05,11,05,07,05,06,05,10
12,12,12,12,12,12,12,12

