11,11,11,11,11,11,11,11
00,00,00,00,00,00,00,00
01,01,01,01,01,01,01,01
02,02,02,04,02,03,02,02
05,09,05,07,05,06,05,08
10,10,10,10,10,10,10,10

